0 0 0 0 0 0 0 0 0 0 0 0 0 0 0 0 0 0 0 0 
0 0 0 0 0 8 3 2 3 2 3 2 3 8 0 0 0 0 0 0 
0 0 0 0 8 0 0 0 0 0 0 0 0 0 8 0 0 0 0 0 
0 0 0 8 0 0 1 0 0 0 0 0 1 0 0 8 0 0 0 0 
0 0 8 0 0 1 5 1 0 0 0 1 7 1 0 0 8 0 0 0 
0 0 8 0 0 0 1 0 0 0 0 0 1 0 0 0 8 0 0 0 
0 0 0 8 0 0 0 0 0 0 0 0 0 0 0 8 0 0 0 0 
0 0 0 0 8 0 0 0 0 0 0 0 0 0 8 0 0 0 0 0 
0 0 0 0 0 8 3 2 3 2 3 2 3 8 0 0 0 0 0 0 
0 0 0 0 0 0 0 0 0 0 0 0 0 0 0 0 0 0 0 0 
0 0 0 0 0 0 0 0 0 0 0 0 0 0 0 0 0 0 0 0 
0 0 0 0 0 0 0 0 0 0 0 0 0 0 0 0 0 0 0 0 
0 0 0 0 0 0 0 0 0 0 0 0 0 0 0 0 0 0 0 0 
0 0 0 0 0 0 0 0 0 0 0 0 0 0 0 0 0 0 0 0 
0 0 0 0 0 0 0 0 0 0 0 0 0 0 0 0 0 0 0 0 
