0 0 0 0 0 0 0 0 0 0 0 0 0 0 0 0 0 0 0 0
0 0 1 2 2 2 2 2 2 2 1 1 1 1 1 1 1 2 0 0
0 0 0 1 0 0 2 6 1 1 2 2 6 1 0 0 2 0 0 0
0 0 0 0 1 0 0 2 7 1 2 7 1 0 0 2 0 0 0 0
0 0 0 0 0 1 0 0 2 6 6 1 0 0 2 0 0 0 0 0
0 0 0 0 0 0 1 0 0 2 1 0 0 2 0 0 0 0 0 0
0 0 0 0 0 0 0 1 0 0 0 0 2 0 0 0 0 0 0 0
0 0 0 0 0 0 0 0 1 0 0 2 0 0 0 0 0 0 0 0
0 0 0 0 0 0 0 0 0 1 2 0 0 0 0 0 0 0 0 0