0 0 0 0 0 0 0 0 3 1 3 0 0 0 0 0 0 0 0 0 
0 0 0 0 0 0 0 3 5 1 4 3 0 0 0 0 0 0 0 0 
0 0 0 1 3 3 3 5 5 1 4 4 3 3 3 1 0 0 0 0 
0 0 0 1 2 2 2 2 2 1 2 2 2 2 2 1 0 0 0 0 
0 0 0 1 2 7 7 1 3 1 3 1 7 7 2 1 0 0 0 0 
0 0 0 0 1 2 5 3 6 1 6 3 5 2 1 0 0 0 0 0 
0 0 0 0 0 1 2 2 2 1 2 2 2 1 0 0 0 0 0 0 
0 0 0 0 0 0 1 2 2 1 2 2 1 0 0 0 0 0 0 0 
0 0 0 0 0 0 0 0 0 0 0 0 0 0 0 0 0 0 0 0 
0 0 0 0 0 0 0 0 0 0 0 0 0 0 0 0 0 0 0 0 
0 0 0 0 0 0 0 0 0 0 0 0 0 0 0 0 0 0 0 0 
0 0 0 0 0 0 0 0 0 0 0 0 0 0 0 0 0 0 0 0 
0 0 0 0 0 0 0 0 0 0 0 0 0 0 0 0 0 0 0 0 
0 0 0 0 0 0 0 0 0 0 0 0 0 0 0 0 0 0 0 0 
0 0 0 0 0 0 0 0 0 0 0 0 0 0 0 0 0 0 0 0 
