0 1 2 3 0 0 0 0 0 0 0 0 0 0 0 0 3 2 1 0
0 2 4 2 1 1 1 1 1 1 1 1 1 1 1 1 2 6 2 0
0 3 2 1 0 0 0 0 0 0 0 0 0 0 0 0 1 2 3 0
0 0 1 0 0 0 2 0 0 0 0 0 0 2 0 0 0 1 0 0
0 0 1 0 0 2 3 2 0 0 0 0 2 3 2 0 0 1 0 0
0 0 1 0 0 0 2 0 0 0 0 0 0 2 0 0 0 1 0 0
0 3 2 1 0 0 0 0 0 0 0 0 0 0 0 0 1 2 3 0
0 2 5 2 1 1 1 1 1 1 1 1 1 1 1 1 2 7 2 0
0 1 2 3 8 8 8 8 8 8 8 8 8 8 8 8 3 2 1 0