0 1 2 3 0 0 0 0 0 2 0 0 0 0 0 0 3 2 1 0
0 2 4 2 0 0 0 0 1 0 2 0 0 0 0 0 2 6 2 0
0 3 2 1 0 0 0 1 0 0 0 2 0 0 0 0 1 2 3 0
0 0 0 0 0 0 1 0 2 0 1 0 2 0 0 0 0 0 0 0
0 0 0 0 0 1 0 0 0 5 0 0 0 3 0 0 0 0 0 0
0 0 0 0 0 0 2 0 2 0 1 0 3 0 0 0 0 0 0 0
0 3 2 1 0 0 0 2 0 0 0 3 0 0 0 0 1 2 3 0
0 2 5 2 0 0 0 0 2 0 3 0 0 0 0 0 2 7 2 0
0 1 2 3 0 0 0 0 0 2 0 0 0 0 0 0 3 2 1 0