0 1 2 3 5 5 5 5 5 5 5 5 5 5 5 5 3 2 1 0 
0 2 4 2 1 1 1 1 1 1 1 1 1 1 1 1 2 6 2 0 
0 3 2 1 6 7 5 1 3 3 3 3 1 5 7 6 1 2 3 0 
0 5 1 5 5 7 2 5 5 5 5 5 5 2 7 5 5 1 5 0 
0 5 1 5 5 2 3 2 4 5 5 4 2 3 2 5 5 1 5 0 
0 5 1 5 5 5 2 5 5 5 5 5 5 2 5 5 5 1 5 0 
0 3 2 1 6 5 5 1 3 3 3 3 1 5 5 6 1 2 3 0 
0 2 5 2 1 1 1 1 1 1 1 1 1 1 1 1 2 7 2 0 
0 1 2 3 5 5 5 5 5 5 5 5 5 5 5 5 3 2 1 0 
0 0 0 0 0 0 0 0 0 0 0 0 0 0 0 0 0 0 0 0 
0 0 0 0 0 0 0 0 0 0 0 0 0 0 0 0 0 0 0 0 
0 0 0 0 0 0 0 0 0 0 0 0 0 0 0 0 0 0 0 0 
0 0 0 0 0 0 0 0 0 0 0 0 0 0 0 0 0 0 0 0 
0 0 0 0 0 0 0 0 0 0 0 0 0 0 0 0 0 0 0 0 
0 0 0 0 0 0 0 0 0 0 0 0 0 0 0 0 0 0 0 0 
