0 1 1 1 1 1 1 1 1 1 1 1 1 1 1 1 1 1 1 0
0 1 0 0 0 0 0 0 0 0 0 0 0 0 0 0 0 0 1 0
0 1 0 2 2 2 2 2 2 2 2 2 2 2 2 2 2 0 1 0
0 1 0 2 0 0 0 0 0 0 0 0 0 0 0 0 2 0 1 0
0 1 0 2 0 3 3 3 3 3 3 3 3 3 3 0 2 0 1 0
0 1 0 2 0 3 3 3 3 6 6 3 3 3 3 0 2 0 1 0
0 1 0 2 0 3 3 3 3 3 3 3 3 3 3 0 2 0 1 0
0 1 5 2 0 0 0 0 0 0 0 0 0 0 0 0 2 5 1 0
0 2 2 2 0 0 0 0 0 0 0 0 0 0 0 0 2 2 2 0