0 0 0 0 0 0 0 0 0 0 0 0 0 0 0 0 0 0 0 0 
0 0 0 0 0 0 0 0 0 6 6 0 0 0 0 0 0 0 0 0 
0 0 0 0 0 0 0 1 3 1 1 3 1 0 0 0 0 0 0 0 
0 0 0 0 0 0 1 3 2 0 0 2 3 1 0 0 0 0 0 0 
0 0 0 0 7 1 3 2 0 1 1 0 2 3 1 7 0 0 0 0 
0 0 0 0 1 3 2 0 0 4 4 0 0 2 3 1 0 0 0 0 
0 0 0 1 3 2 0 0 0 1 1 0 0 0 2 3 1 0 0 0 
0 0 1 3 2 0 0 0 0 0 0 0 0 0 0 2 3 1 0 0 
0 1 5 2 3 3 3 3 3 3 3 3 3 3 3 3 2 5 1 0 
0 0 0 0 0 0 0 0 0 0 0 0 0 0 0 0 0 0 0 0 
0 0 0 0 0 0 0 0 0 0 0 0 0 0 0 0 0 0 0 0 
0 0 0 0 0 0 0 0 0 0 0 0 0 0 0 0 0 0 0 0 
0 0 0 0 0 0 0 0 0 0 0 0 0 0 0 0 0 0 0 0 
0 0 0 0 0 0 0 0 0 0 0 0 0 0 0 0 0 0 0 0 
0 0 0 0 0 0 0 0 0 0 0 0 0 0 0 0 0 0 0 0 
