0 0 0 0 0 0 0 0 0 0 0 0 0 0 0 0 0 0 0 0 
0 0 0 0 0 0 0 0 0 0 0 0 0 0 0 0 0 0 0 0 
0 0 0 0 0 0 0 0 0 0 0 0 0 0 0 0 0 0 0 0 
0 0 1 1 1 1 1 1 1 1 1 1 1 1 1 1 1 1 0 0 
0 0 1 2 6 6 3 3 3 7 7 3 3 3 6 6 2 1 0 0 
0 0 1 4 2 0 0 0 3 3 3 3 0 0 0 2 5 1 0 0 
0 0 1 4 1 2 0 0 0 1 1 0 0 0 2 1 5 1 0 0 
0 0 1 4 2 1 2 0 0 1 1 0 0 2 1 2 5 1 0 0 
0 0 1 3 3 3 3 2 1 3 3 1 2 3 3 3 3 1 0 0 
0 0 0 0 0 0 0 0 0 0 0 0 0 0 0 0 0 0 0 0 
0 0 0 0 0 0 0 0 0 0 0 0 0 0 0 0 0 0 0 0 
0 0 0 0 0 0 0 0 0 0 0 0 0 0 0 0 0 0 0 0 
0 0 0 0 0 0 0 0 0 0 0 0 0 0 0 0 0 0 0 0 
0 0 0 0 0 0 0 0 0 0 0 0 0 0 0 0 0 0 0 0 
0 0 0 0 0 0 0 0 0 0 0 0 0 0 0 0 0 0 0 0 
